40,20
┼││││┼││││┼││││┼                        
│    │    │    │                        
│    │    │    │  │                     
│    │    │    │  │                     
│    │    │    │  │                     
┼││┼┼┼┼┼┼┼┼┼┼┼┼┼││┼│┼│││││││││││││││    
│    │    │    │  │ │                   
│    │    │   ││  │ │                   
│    │    ┼│││┼┼│┼│ │                   
│    │    ┼   ││ ││ │                   
┼││││┼││││┼│││┼┼ │  │                   
          │      │  │ │││││││           
          ┼││││││┼│ │                   
                  │ │                   
                  │ │                   
                  │ │                   
                  │                     
                  │                     
                  │                     
                                        
